R 800 800
NO ./textures/wall_2.xpm
SO ./textures/wall_2.xpm
WE ./textures/wall_3.xpm
EA ./textures/wall_3.xpm



S ./textures/pillar.xpm
C 200,200;200
F 100,100,100

1111111
1000001
10111001
10101001
10101001
10000001
1E202101
10000001
1111111
