R 800 600
C 84, 85, 80
F 120, 122, 124
NO ./textures/eagle.xpm
WE ./textures/purplestone.xpm
EA ./textures/bluestone.xpm
SO ./textures/wood.xpm
S ./textures/barrel.xpm

       1111111111111111111111111
111111112000000001111000000001
111120000000111000000000000001
1111200000001 1000000001111111
120000000000111000011111    1111111111111111111111
10000000022000000000000111111000020202000000100001
10000000000000000000000000000000000000000000100001
10000000000000000000000111111000000000000000000001
120000000000111110000011    1000000000000000100001
12000000000000001001111     1000000000000000100021
111110000000000000010011    1000000000000000100221
    12000000000000001001    1111111011111111111111
    100000W0000000001001          101
1111111000000000100000111111111111101
1000000200000000100000000000000000001
1111111100000011111111111111111111111
100000000000000000111111
1000202021100000000000111
1111111111111111111100001
1222000000000000000000001
1111111111111111111111111
