 
	C   25     , 25 , 255	
      NO    ./pics/pillar.xpm	
	 SO ./pics/panthOBF.xpm	
    WE      ./pics/gribou1.xpm		 	         
  EA ./pics/vint1.xpm	      


      S ./pics/oeil13.xpm	     
	F  255   ,255,   0  

		R 1000 1000	

	11111111111111111111111111111111	  
	1111111111111111000000000000001	
	100000002222222100000000000001111111111	
	100000000000000100000	0000000001
	1111111111111111111111111111111111111111111111111111111111111	

	11111111111111111111111111111111	11111111111111111111111111111111	
	100000000000000100000000000001111111111
	1000000000000000000E000000001111111111	
	100000000000000100000000000001111111111
	10000000222222210000000000000011111111111	
	100000002222222100000000000001111111111	
	100000000000000100000000000001111111111
	1000000000000000000000000001111111111
	100000000000000100000000000001111111111
	10000000000000111111111111111111111	
	11111111111111111111111111111111	

