 
C  255,255,250
F  39,35,36
WE ./pics/panthOBF.xpm	
EA ./pics/yolandi.xpm	
NO ./pics/losanges.xpm		 	         
SO ./pics/gribou1.xpm 

S ./pics/oeil13.xpm    

R 600 800
111111111111111111111111111
111201111000000002011100001111111
1112111110000 02S200001111111
1112111110000 02000001111111
1111111111111111111111111111
1111111111111111111111111111
111211111000000020022000001111111
11121111100000000200000001111111
1111111111111100011111111111111
1111111100000000000000011111111 
11111111111111111111111111111