 
C  255, 255, 250
F  39 , 35 , 36  
NO ./pics/losanges.xpm	
SO ./pics/uni_orange.xpm	
WE ./pics/oeil13.xpm		 	         
EA ./pics/yolandi.xpm 
S ./pics/gribou1.xpm	     

R 800 900

111111111111111111111111111111
11121111100     00000000000001111111
111211111000    00000000S00001111111
1112111110000000000000001111111
1112111110000000000     000001111111
11121111100000000   00000001111111
1111111111111100011111111111111
111111110000000000000001111111  
1111    11111111111111111111111111