 
C  255,255,250
F  39,35,36 
NO ./pics/losanges.xpm	
SO ./pics/uni_orange.xpm	
WE ./pics/oeil14.xpm		 	         
EA ./pics/yolandi.xpm 

S ./pics/oeil13.xpm	     

R 400 400

111111111111111111111111111111
111211111000    0002000000001111111
111211111000 2 0002S200001111111
111211111000    0002000001111111
111211111000000020022000001111111
11121111100000000200000001111111
1111111111111100011111111111111
111111110000000000000001111111  
111111111111111111111111111111