 
C  255,255,250
F  39,35,36 
NO ./pics/vint1.xpm	
SO ./pics/vint1.xpm	
WE ./pics/vint1.xpm		 	         
EA ./pics/vint1.xpm 

S ./pics/gribou1.xpm    

R 400 400
1111111111111 111111111111111
111201111000    0002011100001111111
11121111100001 002S200001111111
111211111000  00020   00001111111
111211111000000020022000001111111
11121111100000000200000001111111
1111111111111100011111111111111
1111111100000000000000011111111 
111111111111111111111111111111